|-----------------------------------------------------------------------------|
|                                                                             |
| |--------------------------|        |-----------------------|               |
| |..........................|        |.......................|               |
| |..........................+########+.......................|-------|       |
| |..........................| #      |...............................|--|    |
| |..........................| #      |..................................|--| |
| |----------+---------------| #      |----+----------------|...............| |
|            #                 #############                |...............| |
|            #                 #     |-----+------|         |@\.............| |
|            #                 #     |............|         |...............| |
|            ###################     |............|   ######+...............| |
|            #                 #     |............|   #     |...............| |
|            #                 #     |-----+------|   #     |--------+------| |
|  |---------+-----------|     #           #          #              #        |
|  |.....................|     #           #          #         |----+------| |
|  |.....................|     ########################         |...........| |
|  |.....................|     #           #                    |...........| |
|  |.....................|     #    |------+--------------------|...........| |
|  |.....................|     #    |.......................................| |
|  |.....................+##########+.......................................| |
|  |.....................|          |.......................................| |
|  |---------------------|          |---------------------------------------| |
|                                                                             |
|-----------------------------------------------------------------------------|
